1111111111111
1001000C00001
1000011011001
10E0P00000011
1111111111111