1111111111111
10010000C0111
1000011111001
10E0P00000111
1111111111111