1111111111111
100100000C001
1000011111001
1P000E0000001
1111111111111